###################
#                 !
#                 #
#                 #
#                 #
#                 #
#                 #
#                 #
#O                #
###################