###################
#     # #     #   !
# ###   # ##### ###
#   ##### #       #
# # #     #   #####
# #   # ### # #   #
# #####     # ### #
# #   ########### #
#O  #             #
###################